abbreviate: выдержка,  выписка, сокращать,  урезывать,  сократить,  сокращать, сокращённый.
accessible: доступный,  достижимый,  поддающийся,  податливый, открытый, достижимо.
accomplish: завершать,  совершать,  совершить,  выполнить, совершающий, заканчивать.
accumulated: аккумулировать,  скопляться,  аккумулироваться,  скучить, наслаиваться,  наслоиться, натекать, наплывать,  наплыть, натечь, налезать,  налезть, нахватать,  подсобрать, налетать, накопленный,  аккумулирующий.
accurate: точный,  правильный,  тщательный,  прилежный, цельный, собранный.
ache: боль,  эйч,  название буквы H,  болезнь, ацетилхолинэстераза, ломота, сострадать,  переживать,  заболевать,  ломить, развиваться,  развиться, разломить,  разламывать, переболеть, болезненный.
acknowledgments: выражения признательности, acute: ударение, обозначенное диакритическим знаком,  на злобу дня,  сильный (acute eyesight – острое зрение,  acute pain – острая боль), острый. WAD Alexander Demidov),  резкий,  животрепещущий,  выраженный.
addendum: дополнение,  приложение,  добавление,  адденда, добавление, Дополнительные условия фрахта после окончания срока действия фрахтового контракта.
addition: прирез (of land,  = прирезка), увеличение,  суммирование,  дополнение,  добавление, прирезка, складывать,  прибавлять,  добавлять, прикладной.
additive: добавка,  добавление,  дополнение,  добавка, присадки, придаточный,  аддитивный,  совокупный,  кумулятивный.
adequately: надлежащим образом,  вполне,  верно,  полноценно.
adjacency: соседство,  смежность, смежность для обмена информацией о маршрутизации. Смежными являются не все пары соседних узлов).
adjacent: сосед, прилежащий,  смежный,  соседний,  граничащий, лимитрофный,  прилегающий, смежный.
admissible: допустимый,  приемлемый,  допускаемый,  имеющий допуск.
aerial: антенна,  связанный с воздухом,  авиа-, антенны, воздушный,  авиационный,  надземный,  эфирный.
aeronautical: авиационный,  воздухоплавательный,  аэронавтический, воздухоплавательный,  воздухплавательный,  аэронавигационный,  авиационный.
agile: внедрение гибких методологий разработки, подвижный,  проворный,  быстрый,  живой.
alignment: расположение по одной линии,  построение в шеренгу,  настройка,  регулировка, расстановка,  расклад сил, расположение.
aligns: размещение объектов относительно друг друга по определённым правилам, выверить,  ставить в ряд,  выстраивать в шеренгу,  располагаться в одну линию, наладочный,  юстирный.
alike:  ... or ... alike, похожий,  подобный,  такой же,  одинаковый.
allocation: размещение,  выделение,  распределение,  локализация, запись в Таблице Распределения Частот определённого частотного диапазона с целью его использования одной или несколькими службами связи в заданных условиях,  резервирование диапазона частот для определённой службы радиосвязи,  распределение,  размещение, отвод, нарезка, разнарядка ядерных средств.
ambiguity: неясность,  двусмысленность,  неопределённость,  двойственность.
analogous: аналогичный,  сходный,  похожий,  схожий.
anomaly: аномалия,  отклонение от нормы,  неправильность,  ненормальность, аномалии.
aperture: отверстие,  скважина,  щель,  жерло, окошко, отверстия, щелевой.
apparent: делать очевидным,  выявлять,  делать явным, различимый,  явный,  очевидный,  несомненный.
appendix: приложение The correct plural of appendix depends on the circumstances. When referring to the text at the end of a book or article, the plural is appendices. In the sense of the organ, appendixes is the only plural),  добавление,  дополнение к документу,  приложение к документу, Дополнение.
applicability: применимость,  пригодность,  целесообразность применения,  актуальность.
appropriate: отводить,  забираться,  забраться,  отпускаться, прирезать, ужиливать, отпускаемый,  закономерный,  подобающий,  приличествующий, в руку, приличный, потенциально возможный,  узурпировать,  апроприировать.
arbitrary: свободное вращение, капризный,  деспотический,  самовольный,  самочинный.
arise: вставание,  восход,  восхождение,  возвышение, возникать,  вставать,  проистекать,  являться результатом, вставать,  встать, вытекать, возведение.
artifact: артефакт,  экспонат,  памятник,  предмет материальной культуры, ascend: восход, Оценка безопасности и клинической эффективности новой дозы,  Исследование сердечно-сосудистых явлений при сахарном диабете, фирма-разработчик телефонных и сетевых средств связи, подниматься,  продвигаться,  вести происхождение,  подняться, приподыматься,  приподниматься,  приподняться, вознёсшийся.
ascending: в порядке возрастания, подниматься,  продвигаться,  вести происхождение,  подняться, приподыматься,  приподниматься,  приподняться, вознёсшийся, идущий по восходящей линии,  идущий по восходящей линии от потомков к предкам,  повышающийся.
ascension: восхождение,  подъём,  вознесение,  приход, Вознесение.
ascent: подъём,  восхождение,  крутизна,  восшествие, взъезд, подниматься, взошедший, взошедший.
assemble: ассамбле (1. прыжок с собиранием вытянутых ног в воздухе,  2. прыжо двух ног на две ноги),  сгрудить, собираться,  формировать,  набирать матричную строку,  собрать, сволакиваться,  сволочиться, стягиваться,  стянуться, напираться, монтировка.
assembly: собрание,  здание общественного назначения,  в сборке,  комплектный узел, сборные изделия,  готовые сборные изделия, низковольтное устройство распределения и управления, курултай, сборочный,  сборный.
assignment: назначение,  ассигнование,  распределение,  выделение, разрешение, выданное административным органом радиостанции на использование радиочастоты или радиочастотного канала в заданных условиях,  присвоение,  закрепление,  распределение, отчисления, Задания.
association: связь,  общество,  ассоциация,  объединение, ассоциации (в психологии,  играют большую роль в искусстве), Начальный протокол о создании компании, якшание, ассоциационный, О-ассоциация.
associative: работающий по совместительству, сообщительный,  симпатичный,  ассоциативный,  общительный.
assuming: принятие,  из расчёта,  принимая во внимание,  если, принять на себя, предположим, самонадеянный,  высокомерный,  надменный,  заносчивый.
assumption: предположение,  принятие на себя,  присвоение,  притворство, предположения,  гипотезы, Успение Пресвятой Владычицы нашей Богородицы и Приснодевы Марии,  Взятие на Небо Успение Пресвятой Девы Марии,  праздник Успения Пресвятой Девы Марии, успенский.
assure: ЕС Workstation аппаратно-программное средство повышения безопасности рабочих станций, бронироваться,  заверяться,  увериться,  уверяться, обеспечиться.
asterisk: сноска,  маленькая звезда,  знак в виде звёздочки, представляющий ссылку в книге,  знак в виде звёздочки, представляющий ссылку в рукописи, отмечать звёздочкой,  отметить звёздочкой,  отмечать звездочкой, помеченный звёздочкой.
attached: прикреплять,  присоединять,  прикомандировывать,  скреплять, пристраивать,  пристроить,  закрепить за,  закреплять за, причисление, подкалывать,  подколоть, прихлёстывать, набивать, присупонивать, прихлёстываться, прикреплённый,  приложенный,  привязанный,  прикомандированный, пришивной.
augmented: прибавлять,  увеличить,  прибавить,  увеличиваться, расширение, увеличенный,  расширенный,  наращённый,  накладной.
axial: по направлению оси, осевой, подмышечный.
azimuth: азимут, азимутальный.
backward: к худшему,  в обратном направлении, движение назад motion, отсталый,  обратный,  запоздалый,  робкий, неразвитой, навзничь,  превратно,  навыворот.
bacon:  bacon baps,  bacon sarnie,  bacon rind, Бейкон, ноги, беконный.
bandwidth: физические, интеллектуальные и эмоциональные ресурсы, ширина полосы, ширины энергетических зон.
bare: медведь,  спекулянт на понижение фондов,  ацедрах,  босой, открывать,  раскрывать,  снимать,  обдирать, декольтированный, неизолированный,  нагой,  голый,  обнажённый, скудный.
baseline: основные данные,  исходная отметка,  база,  ориентир, базовая линия. 1. Нижняя линия строки. 2. Термин, принятый в США для обозначения последней строки полосы набора, контрольная группа (группа подопытных животных или добровольцев, которую используют для сравнения с результатами лечения препаратом LeonIV,  baseline в клин.исследованиях - это отнюдь не "контрольная группа",  это исходный уровень показателей до начала применения исследуемого препарата как в экспериментальной группе, так и в контрольной. Исправьте, пожалуйста. Lviv_linguist), скомпоновать, исходный,  основной.
beach: отлогий морской берег,  взморье,  пляж,  берег озера или большой реки, побережье, прибой, волногаситель, посадить на мель,  вытаскивать,  выгружать на берег,  высаживаться на берег, выброска на берег, береговой,  прибрежный.
beam: рассиять, BeAM фактор по отношению ко времени пробуждения olga don), луч,  бревно,  перекладина,  пучок лучей, пучок альфа-частиц, коромысло, сноп, прогон, пров. Беарн, брус, навой, акции IBM, испускать лучи, просиять, ласково.
bear: медведь,  медвежий мех,  спекулянт на понижение фондов,  ацедрах, носить,  переносить,  выносить,  выдерживать, донестить,  доносить, переболеть,  переболевать, пригуливать, давить, выносить, выносить на своих плечах, приносить, рождать, медвежий.
bearing: отношение,  вид,  облик,  подшипник, направление, вынашивание, носить,  переносить,  выносить,  выдерживать, переболеть,  переболевать, выносить, донестить,  доносить, пригуливать, выносить на своих плечах, приносить, рождать, давить, несущий.
benchmark: целевой ориентир,  точка,  база,  отметка уровня, исходные показатели,  ориентировочные показатели,  сравнительный анализ,  контрольные показатели, сравнительная оценка, база, ориентиры, критерий, ориентировать Yura),  сравнивать реальный объект с эталонным,  сравнивать со стандартом,  сопоставлять с контрольными показателями, знаковый,  референтный,  базовая.
bias: уклон,  наклон,  склон,  покатость, формы предвзятости,  предубеждения,  предрассудки, Биас, пристрастка, высокочастотная очистка поверхности полупроводниковой пластины, склонять,  склонить,  оказывать влияние,  оказать влияние, косо,  косой,  разрезанный,  проведённый и т.п. по косой линии, вкось, неправильно.
bifurcation: раздвоение,  бифуркация,  разветвлённость,  разделение надвое, бифуркации, сечение.
bone: косточка,  кость,  китовый ус,  доллар, 50-ти долларовая доза крека, снимать мясо с костей,  удобрять костяной мукой,  вставлять пластинки в корсет,  вынимать кости, обвалка, костяной.
breach: нарушение и т.п.),  в неправовом смысле – нарушение клятвы, обета, дисциплины и т.п.),  пролом,  пробоина, брешь, действия, совершённые в нарушение, пробивать брешь,  проламывать,  проделать проход,  нарушать, прорывание.
brevity: краткость,  недолговечность,  лаконизм,  сжатость, женские трусики.
buck: антилопы,  самец оленя,  самец,  марка в покере указывающая на сдачу, ответственность: The buck is going to stop with the governors  youtube.com Mr. Wolf),  бак,  бученное бельё,  стирка, бакнер (Buckner,  свита верхнего отдела юрской системы), шалить,  становиться на дыбы,  брыкаться,  стирать в щелоке, противоположный.
bulky: занимающий много места, большой,  объёмистый,  громоздкий,  неуклюжий.
buoyancy: плавучесть,  подъёмная сила,  жизнерадостность,  бодрость, висеть,  повиснуть.
burden: обуза,  грузоподъёмность,  припевка,  ноша, трудить, тяготы, шихта, нагрузить,  нагружать,  отягощать,  отяготить, обременить, нагрузчик,  притеснитель,  гонитель.
carman: возчик,  извозчик,  перевозчик,  возничий, Карман.
cascade: небольшой водопад,  водопад,  каскадный эффект,  кумулятивный эффект, каскадные гамма-кванты, электронно-фотонный каскадный ливень,  каскадный ливень,  каскад,  электронно-фотонная лавина, кодовое название процессора Pentium III Xeon, Каскад (сорт красного винограда,  французский гибрид), каскады, низвергаться,  ниспадать,  ниспадать каскадом,  нисходить, свергаться, катаракт, падун.
castor: ролик,  колёсико,  перечница,  солонка, Кастор (астр.,  звезда в созвездии Близнецов),  огни святого Эльма, судок, наклон шкворня назад, поворачиваться, касторовый, бобриковый, технология сжигания СO2 в химических циклах.
celestial: относящийся к небу,  небожитель,  китаец,  относящийся к небесам, житель Небесной империи,  относящийся к Поднебесной империи, небесный,  божественный,  астрономический,  великолепный, китайский.
chapman: разносчик,  коробейник,  лоточник,  странствующий торговец, Чепман,  Чепмен, Чапмен.
chatter: болтовня,  дрожание,  дробный стук,  щёлкание, болтать,  вести пустой разговор,  трещать,  тараторить, постучать, болтанье, такать, клапан стучит.
chattering: болтовня,  щебетанье, болтанье, болтать,  вести пустой разговор,  трещать,  тараторить, постучать, такать, клапан стучит, вибрирующий.
circumference: периферия,  обхват,  длина замкнутого контура,  замкнутая кривая.
circumferential: окружной,  кольцевой,  окружающий,  периферический.
circumpolar: приполюсный,  кругополярный.
circumvent: захватить хитростью,  окружить хитростью,  расстраивать,  опрокидывать.
clarification: выяснение,  разъяснение,  пояснительная записка,  ясность, уточняющие сведения, сделать понятным,  разъяснять, дефекационный.
cliff: утёс,  отвесная скала,  крутой обрыв,  скала, клиффы, Клифф, лбище.
cluster: скопление,  кисть,  гроздь,  рой, полукруг, купа, Кластер (magnetospheric observations programme, ESA,  программа магнитосферных наблюдений), купа, собираться группами,  толпиться,  тесниться,  расти пучками, обступать,  обступить, сплачиваться,  сплотиться, обсесть, кассетный,  кустовый.
coincidence: совпадение,  случайное стечение обстоятельств,  стечение,  стечение обстоятельств, бета-гамма-совпадение, гамма-гамма-совпадение, рентгено-гамма совпадение, рентген-гамма совпадение, совпадающее бета- и гамма-излучение, коинцидентный.
coincides: совпадение, сходиться,  равняться,  сойтись,  перекликаться, совпадать,  совпасть,  согласоваться,  согласовываться, совпадающий.
collocation: речение, расположение,  расстановка,  словосочетание,  сочетание слов в предложении, взаиморасположение, интерлокационный.
commanded: командовать,  иметь хороший сбыт,  покомандовать,  предводительствовать, командовать,  скомандовать, рявкать команды, дать повеление, командный,  заданный по команде, предводимый.
compactness: компактность,  сжатость,  убористость,  лаконичность, слитость, слитость.
comparatively: относительно,  сравнительно,  в сравнении,  в отношении.
compete: состязание, соперничать,  принимать участие в спортивном соревновании,  участвовать в соревновании,  тягаться, состязаться,  конкурировать,  поспорить, соревноваться, соревновать.
compose: компонист, задумать,  составить,  улаживать,  успокаивать, нанизать.
composed: уравновешенный, задумать,  составить,  улаживать,  успокаивать, нанизать, собранный,  спокойный,  сдержанный,  владеющий собой.
comprise: состоять из,  включать,  заключать в себе,  составлять.
concavity: вогнутая поверхность,  вогнутость,  полость,  впадина.
conceptualization: составление концепции,  представления,  построение концепций,  разработка концепции.
concrete: бетон,  дорожное покрытие из бетона,  бетонироваться,  нечто ощутимое, бетонировать,  превращать в твёрдую массу,  сгущаться,  сгуститься, бетонировка, определённый,  бетонный,  практический,  реально.
conductive: проводящий электрический ток, способный проводить, кондуктивный,  располагающий.
cone: рожок,  шишка,  конус,  пик (горная вершина конической формы, сноп, кулёк, диффузор, придавать форму конуса,  взять в конус,  давать шишки,  обнаруживать самолёт в лучах прожекторов, сноп.
confirmation: подтверждение,  доказательство,  утверждение,  подкрепление, согласие, ратифицированный,  санкционированный,  утверждённый.
conform: приспосабливаться,  приспособляться,  соответствовать,  подчиняться, сообразовываться,  сообразовывать,  согласоваться,  сообразовать, совпадать,  совпасть.
conjugate: родственное слово по корню и значению,  слово общего с другим корня,  слово общего с другим происхождения, конъюгаты, спрягаться,  соединяться,  соединять,  спариваться, сопряжение,  транспонирование, сопряжённый,  соединённый,  парный.
consecutive: непрерывно следующий друг за другом,  следующие друг за другом,  подряд идущие,  непрерывно следующий друг за другом, последующий,  последовательный,  следственный,  следующий непрерывно.
constancy: постоянство,  верность,  настойчивость,  непреклонная решимость.
contemplate: размышлять,  созерцать,  пристально рассматривать,  рассматривать, созерцать.
contrary: нечто противоположное,  обратное,  нечто обратное,  противоположность, противоположности, противоположный,  обратный,  противный,  своевольный, противно своему обыкновению Stas-Soleil),  не соответствующий,  противное,  противоречить.
controllability: управляемость.
convention: собрание,  договор,  соглашение,  обычай, съезд, Национальный конвент (National Convention,  во Франции, в 1792-95 гг.), правила.
converge: направляться к одной точке,  приближаться,  приблизиться,  сойтись.
convergence: сближение,  схождение в одной точке,  конвергенция,  взаимодействие.
convergent: сходящийся в одной точке.
convex: выступ, образовывать выпуклую поверхность, выгнутый,  круглый.
convexity: выгнутость.
coordinated: координировать,  приводить в соответствие,  согласовывать,  устанавливать правильное соотношение, соображать,  сообразить, координированный,  согласованный.
corollary: следствие,  заключение,  естественное следствие,  естественный результат, добавочный,  взаимодействующий,  логически вытекающий,  сопутствующий.
correspondence: соответствие,  аналогия,  корреспонденция,  переписка, заочный.
corroborate: подтверждать,  подтвердить,  подкрепить,  скрепить, подтверждённый независимыми друг от друга источниками.
costate: сопряжённое состояние, жилковатый,  ребристый,  ребрастый,  ребристый.
critical: первой важности,  относящийся к кризису, критический,  решающий,  переломный,  опасный, требовательный,  разборчивый,  строгий,  тонкий.
crossing: перебегание, перечёркивание,  зачёркивание,  скрещивание,  перекрёсток, кроссирование, перекрёсток, переезд,  переход, крещение, рейс, закрещивание, техника передачи мяча в атаку верхом, скрутка, закрещивание,  крещение,  перевальный,  перекрещение, переходить, закрестить, перевалить, перебежать, переездной.
crucial: поворотный круг, ключевой,  критический,  крестообразный,  значимый.
cumulative: кольцо,  манжета,  наружное кольцо конического роликового шарикового радиально-упорного подшипника,  наружное кольцо конического разъёмного шарикового радиально-упорного подшипника, кумулятивные привилегированные акции, накопленный,  совокупный,  кумулятивный,  накопительный.
curl: курчавость,  завиток,  локон,  спираль, витки волос, закручивать,  завивать,  крутить,  виться.
curvilinear: нелинейный,  криволинейный.
damp: сырость,  подавленное настроение,  подавленность,  влажность, амортизировать,  заглушать,  обескуражить,  обескуражить (damp somebody's ardour – охладить чей-либо пыл, приглушать,  приглушить, амортизировать, влажный,  сырой,  волглый,  запотевший, гнилой.
damping: успокаивание,  успокоивание,  глушение,  затухание, амортизировать,  заглушать,  обескуражить,  обескуражить (damp somebody's ardour – охладить чей-либо пыл, приглушать,  приглушить, амортизировать, затухающий,  увлажняющий.
dashed: бросаться,  мчаться,  нестись,  ринуться, слетать, наплывать,  наплыть, пронестись,  проноситься, нанести, полететь, штриховой,  пунктирный,  пунктирный,  разбитый.
davenport: изящный письменный столик,  кушетка,  небольшой стильный письменный стол,  тахта, г. Давенпорт,  г. Давенпорт, изящный письменный столик с наклонным верхом и ящиками, выдвигающимися сбоку.
debris: обломки,  осколки, обломки горных пород при обвале.
decade: десятилетие,  десять лет,  десятилетний период,  период в десять лет, декадный,  десятичный.
decay: приходит, гниение,  разложение,  увядание,  порча, бета-минус-распад, бета-минус-распад, альфа-распад, гамма-распад, общее число актов распада, преклонность, захиреть,  гнить,  разлагаться,  портиться, приходить в упадок, исчезать, захиреть, сдавать.
decent: приличный,  благопристойный,  скромный,  пристойный.
decisively: самое главное: Most decisively, Michel had made her swear to keep their secret. Abysslooker),  убедительно,  решительно,  несомненно.
declare: декларировать, высказываться,  заявлять,  признавать,  показывать, описывающий.
dedicate: передавать в дар, посвящать,  отдавать,  заполнять время,  надписывать, отдать жизнь, специально предназначенный, посвящённый,  освящённый.
dedicated: специально предназначенный, посвящать,  отдавать,  заполнять время,  надписывать, отдать жизнь, посвящённый,  посвятивший себя,  убеждённый,  ориентированный на определённую круг задач.
definite: определённость,  однозначность, ясный,  точный,  недвусмысленный,  чётко выраженный.
definition: дефиниция,  толкование,  ясность,  объяснение, значения, определение термина.
deflect: отклонение, преломлять,  отклоняться,  изменять направление,  менять.
defunct: delay: проволочка,  остановка,  опоздание,  промедление, оттяжка, отсрочивать,  медлить,  отсрочить,  замедлять, замедлить, замедленный, замедленный,  задержанный.
denote: для обозначения, обозначать,  означать,  указывать на,  показывать.
depart: отход,  отбытие,  уход,  отъезд, отступить,  отступать,  отбывать,  отправляться, уходящий со своего поста, сваливать,  свалить, убылой.
departure: уход,  отправление,  отплытие,  выступление, разлёт, отлёт, выходящий поток, расписание отправления рейсов, вылет, исходный,  отправной,  разъездной, разлёт.
depict: рисовать,  описывать,  запечатлевать,  нарисовать, отрисовать.
deputy: выборный,  уполномоченный.
derivation: образование,  получение,  извлечение,  источник, выкладки.
derive: пакет математических программ, получать,  происходить,  наследовать,  производить, возвести,  возводить.
designate: лицо, назначенное, но ещё не вступившее в должность, определять,  устанавливать,  называть,  означать, назначение,  целеуказание, назначенный, но ещё не вступивший в должность,  временно исполняющий обязанности.
designation: обозначение,  называние,  десигнация,  определение, обозначения.
desire: желание,  страсть,  вожделение,  просьба, испытывать желание,  хотеть,  просить,  выражать желание, охотиться, желаемый.
deviate: уклоняться,  отходить,  уклоняться,  идти вразрез, отойти,  отходить, отклоняться, странный,  ненормальный,  необычный.
devise: завещанное имущество,  завещание,  завещательный отказ недвижимости,  легат, завещанная недвижимость,  изобретать,  разрабатывать,  задумывать, завещать.
dimensionality: протяжённость.
ding: звон,  громко ударять обо,  громко колотить обо, звенеть,  назойливо повторять,  зазвенеть,  вдолбить, перегибы-дефект.
discontinuity: разрыв непрерывности,  дискретность,  отсутствие последовательности,  разрыв, перерывы постепенности,  разрывы,  скачки, незамкнутость, разрывный.
discontinuous: не сплошной, прерывистый,  лишённый непрерывности,  прерывающийся,  перемежающийся.
discover: открыть,  открыть для себя, нащупывать,  нащупываться,  обнаруживаться,  обнаружиться, нащупать,  нащупывать, наоткрывать, отыскаться,  отыскиваться,  улавливать,  улавливаться.
discrepancy: несоответствие,  расхождение,  различие,  несогласие, различия, расхождение.
distinct: ясный,  явственный,  отчётливый,  членораздельный, раздельный.
distortion: искажение,  искривление,  перекашивание,  извращение, экономические перекосы,  экономические искажения, искажение,  искажение, дисторсия, расхождение,  несовпадение.
disturbance: пертурбации,  волнение,  тревога,  беспокойство.
disturbances: беспорядки,  волнения,  беспорядок,  волнение, пертурбации,  волнение,  тревога,  беспокойство.
diverge: отойти от стандарта, разойтись,  расходиться,  отходить,  приобретать отличие, отклонившийся,  отшедший,  разошедшийся, отойти,  отходить.
docking: постановка в док,  стыковка,  стоянка в доке, вводить в док,  входить в док,  оборудовать доками,  подрезать, состыковать,  состыковываться,  состыковаться, стыковочный.
dong: звук колокола,  дон,  донг,  тон, звучать,  звучать,  прозвучать.
dotted: один из наиболее известных генов-модификаторов мутаций с образованием А), ставить точки,  усеивать,  испещрять,  поставить точки, усевать,  обсеять, рассеивать,  рассеять, крапать, с точкой,  с точками,  отмеченный или намеченный точками или точкой,  усыпанный.
dozen: дюжина,  масса,  дюжинный,  десяток, дюжина, впадать в оцепенение,  изумлять,  ошеломлять,  поражать, онемелый.
drastic: крутой,  радикальный,  коренной,  сильнодействующий.
drastically: решительно,  круто,  радикально,  в огромной мере.
drill: тренировка,  учёба,  сверло,  подготовка, дрель,  дриль, бормашина, пробуравливать,  пробурить,  высверливать,  высверлить, досверлить,  досверливать, высверливать,  высверлить, насверливать,  насверлить, вертельный, просверливать, dump: груда хлама,  куча мусора,  глухой звук от падения тяжёлого предмета,  свинцовый кружок, раздрызг, опрокидывать,  сваливать,  вываливать,  сбрасывать, сброс, сбрасывать, бросовый, захолустное место, свойство прямого универсального отображения.
dumping: демпинговые продажи, вываливание,  выгрузка,  разгрузка навалом,  демпинг, сброс, опрокидывать,  сваливать,  вываливать,  сбрасывать, сбрасывать, демпинговый.
eccentricity: эксцентричность,  странность,  оригинальность,  чудачество, эксцентричность, нестандартные дебюты, вне-центренность, эксцентрика.
eddy: водоворот,  вихрь,  маленький водоворот,  облако, Эдди, клубиться,  кружиться в водовороте,  завихряться,  свиться, вертящийся,  крутящийся.
edge:  cutting-edge,  give an edge, востриё, боковые рёбра лыжи,  боковые рёбра, стандарт сотовой связи, реализующий скорость передачи данных 384 кбит/с,  увеличенные скорости передачи данных в системе GPRS до 384 кбит/с, GPRS — general packet radio service — общая пакетная радиослужба, фальц, грань поля нарезов, точить,  медленно продвигаться,  постепенно приближаться,  столкнуть, выметка,  вымётывание,  обрезывание, окаймить,  окаймлять, заострённый,  дерзкий,  грядка, Технология EDGE.
eigenvalue: эйгенвеличина, множество собственных значений.
elect: избранники,  избранник, выбирать,  выбрать,  решить,  предпочесть, выборный,  избираемый, избрать,  избирать, избирание, отборный,  самый лучший,  выбранный,  отобранный.
elimination: выбрасывание,  выбывание,  устранение,  уничтожение, отборочное соревнование,  предварительное соревнование, отборочный, вложенный.
elongate: повытянуть, удлиняться,  удлинять,  растягивать,  растягиваться, вытянутый,  удлинённый.
embed: прикрепление The process of limiting press access to a conflict begins when a reporter applies for embed status. All reporters are carefully vetted by military public affairs officials. This system is far from unbiased. Unsurprisingly, reporters who have established relationships with the military are more likely to be granted access.... Army public affairs officials said this was to protect operational security, but it also allowed them to terminate a reporter's embed without appeal.... A Pentagon spokesman said, "Embeds are a privilege, not a right.:".  nytimes.com Illinykh), закладные детали, вмазывать,  вделывать,  заделывать,  вкраплять, заделывание, утопить.
endow: вклад,  дар,  донор,  жертвователь, делать дар,  обеспечивать постоянным доходом,  материально обеспечивать,  жертвовать вклад, обдаривать (impf of обдарить,  = одаривать),  одаривать,  обдарить.
enforce: сила,  крепость,  насилие,  действительность, принуждать,  настаивать на,  усиливать,  настаивать.
enhancement: улучшение,  оздоровление,  оптимизация использования,  повышение, дополнительные возможности, совершенствование.
enlarged: увеличиваться,  расширяться,  разрастаться,  распространяться, увеличенный,  распространённый.
ensure: обеспечивать,  гарантировать,  ручаться,  поручиться, благодаря чему.
entail: акт,  майоратное наследование,  майорат,  назначение наследника, вызывать,  навлекать,  вызвать,  навлечь, вызывающий,  стимулирование, ведёт.
epoch: эпоха,  век,  эра,  поворотный пункт, схема химиотерапии EPOCH.
equinox: равноденствие, точки равноденствий.
equiprobable: одинаково возможный.
erratic: эксцентричная личность,  чудак,  оригинал, колеблющийся,  рассеянный,  странный,  беспорядочный, неравномерный,  изменчивый,  непостоянный.
essence: сущность,  существо,  эссенция,  экстракт, эссенции, солевой.
existent: качество,  объект, существующий,  происходящий,  наличный,  нечто существующее.
expenditure: расходование,  расход,  трата,  потребление, расходный.
exploit: подвиг,  ломалка,  хакерская программа,  взлом, похождения, разрабатывать,  разрабатывать,  пользоваться,  использоваться, спекуляция.
exponent: истолкователь,  представитель,  образец,  тип, объяснительный.
fabrication: производство,  изготовление,  выдумка,  ложь, сборные конструкции, производственный,  технологический.
facilitate: способствовать,  содействовать,  оказать содействие,  поспособствовать, содействие, облегчать задачу, облегчающий, оказывать содействие, облегчённый.
fairer: достойный We want to make sure they are given a fair fee for their hard work in the project. I. Havkin),  закономерный,  без дождя,  белый, сходный, сходный.
favorable: подходящий,  удобный,  расположенный,  симпатизирующий.
fax: факс,  фототелеграмма,  фототелеграф,  факс-аппарат, посылать факс,  передавать по факсу,  дать факс,  посылать копии отпечатанных материалов, письма, чертежи и т.п. по фототелеграфу, факсимильный, обозначение для фиксированных воздушных станций.
feasibility: выполнимость,  осуществимость,  возможность,  обоснованность, сбыточность.
feasible: выполнимый,  возможный,  вероятный,  правдоподобный, возможно,  выполнимо,  вероятно,  осуществимо.
fellow: товарищ,  собрат,  принадлежащий к той же группе,  парень, мальчики,  парни, оголец, член, обращаться дружески,  найти пару,  обращаться фамильярно, подобранный,  парный, занимающийся исследовательской работой учёный,  товарищеский,  равный.
fidelity: верность,  преданность,  лояльность,  точность, приверженность лечению, естественность.
finiteness: предельность,  границы,  определённость.
fit: схватки,  подгонка,  прилаживание,  фит, годиться,  устанавливать,  совпасть,  смонтировать, вставать,  встать, приделывать, лезть,  полезть, приделать, прилегать,  прилечь, налезать,  налезть, пришабривать,  пришабрить, приладить,  прилаживать, померить, всходить, укладываться, притачивать, пристрагивать, подгонять, годный, угодный, отказ во время испытаний.
fitted: годиться,  устанавливать,  совпасть,  смонтировать, вставать,  встать, приделывать, лезть,  полезть, приделать, прилегать,  прилечь, налезать,  налезть, пришабривать,  пришабрить, приладить,  прилаживать, померить, всходить,  взойти, укладываться, притачивать, пристрагивать, подгонять, приспособленный.
flock: стадо,  стая,  отара,  дети, очёска, станица, очески, свадьбище, паства, стекаться,  скапливаться,  собираться толпой,  держаться вместе, перевалиться,  переваливать,  переваливаться, валить, обсесть.
flywheel: маховое колесо,  маховик, маховиковый.
foll: ford: переправа,  брод,  река,  дешёвое платье, скопированное с дорогой модели, Форд,  форд,  популярная модель, переходить вброд,  перейти вброд,  переправляться вброд,  переходить, Области деятельности НИОКР.
fore: эй,  авангард,  первый план (bring something to the fore,  come to the fore Telecaster), до-,  пред-, передний,  заметный,  старший,  на переднем плане, передний, наперёд,  заранее, прежде,  перед от before, подтверждение  thefreedictionary.com Phyloneer),  перед, пред-,  перед.
forklift: автопогрузчик,  грузоподъёмник.
fur: шуба,  налёт,  мех,  шкура, язык фур, пушная рухлядь,  мягкая рухлядь,  пушок,  известковая накипь, донесение об отказах или неудовлетворительной работе,  отказ, неудовлетворительная работа или замена, покрывать накипью или налётом,  покрываться накипью или налётом,  счищать накипь,  подбивать или отделывать мехом, меховой,  пушной, РФС.
furnish: композиция бумаги,  состав бумаги,  украшение, обставлять,  меблировать,  снабжать,  предоставлять, укомплектовывать,  удовлетворить,  удовлетворять,  укомплектовать, обмеблировать.
gather: урожай,  снять,  складки,  сборка, созывать митинг,  съехаться,  обрастать,  отбирать, набранный, нарвать, скапливаться, насобирать, скопляться, добирание, стягиваться,  стянуться, напираться,  находить, обсесть, сбирание, натолкаться, набредать.
genus: класс,  сорт,  вид, вид, колено.
gimbal: гиростабилизатор камеры, подвес карданов, поворачивать в карданном подвесе,  поворачиваться в карданном подвесе,  отклонять двигатель в карданном подвесе,  устанавливать двигатель с помощью универсального шарнира.
glover: перчаточник,  перчаточница,  продавец перчаток, Гловеры, "перчаточники" Юрий Гомон).
goodman: йомен, Гудман.
govern: руководить,  направлять,  регулировать,  определять.
gradually: постепенно,  мало-помалу,  понемногу,  исподволь.
grant: выдача,  пособие,  дар,  субсидия, субсидия,  дотация,  безвозмездная ссуда, грант на научное исследование, дать,  жаловать,  даровать,  разрешать, ниспосылать, жаловать.
grippers: захваты на групповом комбезе, бейлиф,  большая кнопка,  судебный пристав, эспандер.
guest: гость,  постоялец,  паразит,  клиент, ночлежница,  ночлежник, постоялица,  постоялка,  постоялец, гостевой, пансионерка,  пансионер, встроенная группа в папке Groups, Windows 2000, приглашённые лица, учётная запись для регистрации в компьютере без использования специально созданной учётной записи, не требует ввода пароля и по умолчанию блокирована, гостить,  принимать как гостя, выступление актёра режиссёра и др. в качестве приглашённого,  гастрольная жизнь, гостевой,  приглашённый,  гастролирующий,  приезжий.
handbook: руководство,  справочник,  справочник туриста,  путеводитель.
handle: ручка,  рукоятка,  удобный случай,  предлог, ручки, крыж, поручень, гриф, обрабатывать,  производить транспортную обработку груза,  разбираться,  пропускать, обращение, полгаллона.
hare: заяц,  безбилетный пассажир, Заяц, бежать как заяц,  припустить,  рваться,  гнать, заячий.
heme: ребро готического свода, гемовый,  моллюски,  красное мясо,  рыба. 'More).
hence: следовательно,  отсюда,  с этих пор,  прочь, прочь отсюда!.
henceforth: в последующем, с этого времени,  впредь,  отныне,  этого времени.
heuristic: правило, способствующий, эвристический.
hierarchical: иерархическая, иерархический.
hill: съезд, холм,  возвышенность,  пригорок,  возвышение, высота, возвышенность, сопка, окучить,  насыпать кучу,  окучивать,  накоплять, с холмами,  на холмах, окучка.
homogeneous: гомогенный,  однородный.
hood: капюшон,  чепец,  чепчик,  клобук, иерархическое объектно-ориентированное проектирование, гопота, капюшон (of a protective mask,  противогаза), капюшон, Гуд, закрывать,  скрывать,  прикрывать,  замазывать, гангстерский,  "пацанский",  "пацановский",  бандитский.
hover: парение,  свободный полёт,  ожидание,  неопределённое положение, подлёт, парить (о птице, технике,  тж. hover about, hover over: A helicopter hovered overhead.  cambridge.org),  застывать (над чем-либо,  в ожидании: A waiter hovered at the table ready to take our order.  cambridge.org), витать, увиваться,  увиться, виться, мелькает.
hyperbolic: гиперболический,  преувеличенный, преувеличенный,  гиперболичный.
ilk: тот же самый, однотипный (в выражениях,  of that ilk – из места, название которого совпадает с фамилией, Guthrie of that ilk – Гутри из города Гутри, and others of that ilk – того же рода), Интегрин-связанная киназа.
imaginary: мнимое число, мнимый,  химерный,  выдуманный,  нереальный.
imperative: обязанность,  долг,  приказ,  приказание, требования времени, повелительный,  императивный,  необходимый,  властный.
implement: орудие,  инвентарь,  принадлежности (в основном – pl, мн.ч.,  writing implements – письменные принадлежности Franka_LV), внедрить,  осуществлять,  осуществить,  выполнять.
implicit: подразумеваемый,  имплицитный,  безоговорочный,  скрытый.
implies: подразумевать,  предполагать,  означать,  заключать в себе, указывать.
imply: подразумевать,  предполагать,  означать,  заключать в себе, указывать.
impose: требовать (чего-либо,  A new environmental standard imposes the use of new equipment. I. Havkin), облагать,  налагать,  возлагать,  навязывать, взимаемый, налагать,  навязывать,  облагать, наверстать,  навёрстывать, злоупотреблять чьим-либо вниманием, всунуть,  всовывать, хиротонисать.
inadequate: не отвечающий требованиям,  не соответствующий чему-либо, ущербный,  нецелесообразный, нерациональный,  несуразный,  несовершенный, неуважительный.
inclination: наклонение,  уклон,  склон,  откос, задатки, тяготение, склонности, позыв.
incommensurable: не имеющий общего множителя, несоизмеримая величина, несоразмерный,  непропорциональный,  несоизмеримый,  несопоставимый, несопоставимо.
incorporate: объединение, оформить учреждение в качестве юридического лица,  включать в число членов,  соединять,  объединять, свести,  сводить, получивший статус города,  объединённый,  нераздельный,  соединённый.
incorporates: объединение, оформить учреждение в качестве юридического лица,  включать в число членов,  соединять,  объединять, свести,  сводить.
indispensable: необходимый,  обязательный,  не допускающий исключений,  неотъемлемый.
indoor: induce: разманить, обсвистать, вдохновиться,  вдохновлять,  вдохновляться,  вызваться, подговаривать,  подговорить,  уговорить, обсвистывать, уговаривать.
induced: вдохновиться,  вдохновлять,  вдохновляться,  вызваться, подговаривать,  подговорить,  уговорить, уговаривать, обсвистывать, обусловленный.
inferior: младший по чину,  лицо, стоящее ниже по положению, рангу, званию,  подчинённое лицо,  увечный, находящийся ниже,  более поздний,  стоящий ниже,  низший.
infinitesimal: бесконечно малая величина, бесконечно малый,  чрезвычайно малый,  не поддающийся измерению,  бесконечный.
inherent: присущий,  свойственный,  прирождённый,  внутренний.
inherently: по своему существу,  в своей основе,  от природы,  изначально.
inhomogeneous: неоднородность,  гетерогенность, неоднородный,  неравномерный,  разнородный.
install: официально вводить в должность, проводить,  поселять,  монтировать,  водворять, вселить,  вселять, усаживаться.
instantaneous: одномоментный,  мгновенный,  немедленный,  одновременный.
insure: застраховать,  страховать,  застраховаться,  страховаться, застрахование,  страховка, страховать,  застраховать.
intend: хотеть,  собираться,  предназначить,  значить, намереваться,  преднамериться,  метить,  наметить, приуготовить,  приготовлять, рассчитанный, собираться.
interchangeably: как взаимозаменяемые синонимы,  как синонимы,  попеременно,  как взаимозаменяемые, чередующийся,  заменимый,  взаимный,  обоюдный, сменяя друг друга,  Синонимичное употребление слов схожих по созвучию,  синонимически,  синонимично.
interleave: перемежить,  переплетение, прокладки между листами рессоры для уменьшения трения между ними, располагать чередующимися пластами, слоями,  прослаивать,  прокладывать белую бумагу,  прослоить.
intern: стажёр,  практикант,  интерн, стажироваться,  быть стажёром,  ординатор,  интернироваться, интернирование, интернированный, интернированный,  внутренний,  душевный,  сокровенный.
intractable: неподатливый человек,  не подчиняющийся дисциплине,  несговорчивый человек, непокорный,  неподатливый,  труднообрабатываемый,  трудноизлечимый.
intuition: интуиция,  наитие,  чутьё,  непосредственное восприятие, интуитивные представления.
intuitively: чутьем,  по догадке,  интуитивно,  на интуитивном уровне.
investigated: изучаемый, разбирать,  расследовать,  изучить,  разузнавать, выведывание, разбирать,  разобрать, изучающий, исследовать.
jersey: модульный блок типа "Нью джерси", тонкая вычесанная шерсть,  куртка из шерстяной ткани,  фуфайка из шерстяной ткани,  джерси, джерсейская порода.
jurisdictional: попадающий под юрисдикцию, подведомственный,  подсудный.
lambert: Лб, Ламберт,  черешня ламберт, ламбертовский.
lane: Лейн, тропинка,  узкая улочка,  переулок,  разводье между льдинами, боулинг, полоса движения, полоса движения, замкнутый,  необщительный,  уединённый,  путь, эмуляция локальных сетей.
lap: колени,  пола,  фалда,  подол, процедура доступа к каналу,  протокол доступа к каналу, укрутить, функция проигрывателя компактдисков фирмы Panasonic, плескаться,  вылакать,  обгонять на круг,  обогнать на круг, обматывать,  обмотать, дохлестнуть,  дохлёстывать, глотание, жидкий,  свернуть, ПДС-предельно допустимые сбросы.
lares: лары,  домашние боги, лары, покровитель общины,  лар, покровители общины, белорукий гиббон.
lateral: ответвление,  боковая часть,  латеральный сонант,  ветвь, боковой,  поперечный,  побочный,  вторичный.
latitude: свобода,  терпимость,  обширность,  широта, географическая широта, широтный.
latter: последний из двух, недавний,  последний (из двух названных,  противоп. the former),  сей последний.
launcher: гранатомёт,  летательная установка,  установка, метательная установка.
lean: наклон,  постное мясо,  низкооплачиваемая работа,  отклонение, иллюзия крена ЛА,  иллюзия наклона ЛА, Лин, нагибаться,  сгибаться,  наклонять,  полагаться, опирать,  приваливать,  привалить,  упереть, наваливаться, опереться,  опираться, налегать,  налечь, подтянутый,  постный,  худой,  тощий, тощий, система LEAN.
leveraged: см. highly leveraged.
leveraging: с использованием.
lightly: чуть,  с лёгким сердцем,  без усилий,  слегка.
limitation: ограничение,  оговорка,  ограниченность,  предельный срок, лимитирующий.
lin: масса воды,  площадь воды, погонный, лланвирнская эпоха, переставать,  уступать, линейный, линейность траектории, лланвирнский ярус,  лланвирн,  лланвирнский.
lisp: лепет,  шорох,  шелест,  картавленье, Лисп, лепетать (о детях,  To speak with imperfect articulation,  to mispronounce, such as a child learning to talk),  картавить.
lite: лёгкий, -лит, низкокалорийный, технологические эксперименты в космосе с использованием лазерного локатора в рамках НАСА, США.
loan: ссуда,  кредит,  книги по абонементу,  ссуда под проценты, произведения искусства, предоставленные во временное пользование, заем, давать деньги под проценты,  предоставлять заём,  одолжаться,  одолжиться, ссудный,  заёмный.
locomotion: передвижение,  способность передвижения,  передвижка,  перемена места.
lone: вдовая,  дорожка,  переулок, замкнутый,  необщительный,  незамужняя,  необитаемый.
longitude: длина,  меридиан, географическая долгота.
lope: размашистая походка,  прыжки,  скачки,  лёгкий шаг, идти размашистым шагом,  скакать,  бежать вприпрыжку,  прыгать.
lunisolar: солнечно-лунный.
lustrate: приносить очистительные жертвы,  совершать обряд очищения,  люстрировать,  очищать.
maintenance: содержание,  поддерживание,  сохранение,  продолжение, ремонтный,  хозяйственный блок.
marcel: горячая завивка волос,  горячая завивка, Марсел, горячая завивка, завивать волосы щипцами,  завивать волосы горячими щипцами.
march: развитие,  походное движение,  суточный переход,  переход, март, маршировать,  уводить,  заставлять уйти,  вести строем, вступать,  вступить, промаршировать, маршевый,  походный,  шествие,  кампания, марш,  кругом марш!, мартовский, марш.
mare: кобыла,  бросок с захватом рук на плече,  море на Луне,  самка лошади, кобылятина, Мар.
margin: край,  грань,  полоса,  опушка, марго, окаймлять,  оставлять запас,  запасти,  делать заметки на полях, маргинальный,  предельный.
martin: фирма "Мартин", городская ласточка,  каменный стриж,  зимородок, Мартин (имя / фамилия,  100%, ударение на первый слог ABelonogov).
mat: Мэт,  Мэт или Matthew), приборная доска,  подложка, управляемая противотанковая ракета, Матильда,  Матвей,  Матфей, прикрывать рогожей,  делать настил,  настилать,  спутывать, сваливаться,  сваляться, матовый,  неполированный,  тусклый, срок долгового обязательства, терминал технического обслуживания.
maul: колотушка,  кувалда,  глинистая или вязкая почва,  схватка вокруг мяча, избивать,  калечить,  терзать,  неумело или грубо обращаться, грубо.
maxi: пальто до щиколотки, макси,  макси-юбка,  мода на длинные юбки,  увеличенный.
merit: заслуга,  достоинство,  добродетель,  права, хорошесть, Мерит, заслуживаться,  заслуживать,  заслужить,  быть достойным.
meth: метиловый спирт,  древесный спирт,  гидроксид метила,  метилгидрат, метод, денатурат,  метилированный спирт.
microgravity: микрогравитация.
mild: нежный для восприятия, мягкий,  умеренный,  кроткий,  неострый, МИОСМнемонически Индуцированное Осознанное Сновидение.
ministry: министерство,  кабинет министров,  срок пребывания у власти министра,  срок пребывания у власти министерства, Министри.
minus: недостаток,  пробел,  знак минуса,  знак минус, несуществующий,  без,  лишённый,  отрицательный, без.
mod: батарейный блок,  блок аккумуляторов, ультрасовременный молодой человек,  стиляга,  модник,  модница, последний писк моды, модифицировать, стильный,  хипповый,  модерновый,  раскованно или развязно, отпадный,  модернистский,  авангардистский,  раскованный, образец, максимальная глубина погружения,  максимальная рабочая глубина, развязный.
modular: состоящий из свободно заменяемых частей, Модулор, блочно-модульного исполнения (adj. made of standardized units which can be assembled in different ways,  of or relating to a module. BabEn Alexander Demidov),  блочно-модульный,  в блочном исполнении, модульный Компоненты, которые можно легко подключить к устройству или отсоединить от него. 2) Разъём напр., телефонный), позволяющий легко подключить кабель к устройству или другому кабелю).
momentary: кратковременный,  моментальный,  мгновенный,  преходящий.
multiplicative: имеющий способность размножать, увеличивающий,  увеличивающийся,  размножающийся,  относящийся к размножению.
multistage: многокамерный,  многоярусный,  многоэтажный,  многостепенный.
mutual: общество взаимного страхования, взаимный,  обоюдный,  общий,  совместный.
mutually: в двустороннем порядке, обоюдно,  взаимно,  совместно.
nates: передние бугры четырёххолмия головного мозга.
navy: военно-морские силы,  военно-морской флот,  тёмно-синий цвет,  морское ведомство, флот военно-морской, военно-морской, ВМС,  ВМФ.
negate: нивелировать, отрицать существование или истинность,  отвергать,  отрицать,  отвергнуть.
negates: нивелировать, отрицать существование или истинность,  отвергать,  отрицать,  отвергнуть.
neglect: пренебрежение,  небрежность,  нерадивость,  невнимание, запустение, пренебрегать,  не заботиться,  упускать,  не позаботиться, не принимать во внимание выстрел по ошибочным данным!, пренебрежительно относиться к,  не заботиться о,  не обращать внимания на, нерадивый человек,  небрежный человек.
negligibly: ничтожный,  не принимаемый в расчёт,  пренебрежимо мал,  которым можно пренебречь, почти не,  ничтожно,  очень мало,  чуть-чуть.
neither: ни тот, ни другой,  никто,  ничто,  ни один, никакой,  также не,  тоже не, ни то, ни другое,  ни,  ни те, ни другие.
nevertheless: как бы то ни было, однако при этом,  однако, тем не менее,  несмотря на это,  несмотря на,  хотя.
nil: ноль, Нормальный уровень раздела фаз, ничего,  нулевой.
notational: obliquity: отклонение от прямой линии,  косое направление,  наклонное положение или движение,  отклонение от прямого пути, косое направление, искривление, от нормы.
obstacle: помеха,  закавыка,  преграда,  загвоздка, препятствия, тормозной.
occasionally: изредка,  временами,  время от времени,  иногда.
oftentimes: часто,  зачастую,  частенько,  нередко.
omit: упускать,  пренебрегать,  не включать,  пренебречь, пропущенный,  упущенный, исключая.
optimum: наиболее благоприятные условия,  оптимум,  совокупность наиболее благоприятных условий,  наиболее эффективный, оптимальный,  трудный.
orthonormal: ортогональный нормированный.
osculate: поцелуй, приводить в соприкосновение,  соприкоснуться,  целовать,  лобызать.
outward: внешний мир,  внешность,  экстерьер,  материальный, объективный мир, внешний,  наружный,  за пределы,  наружний, наружу, изнутри.
overburdened: перегружать,  нагружать сверх меры,  отягощать,  перегрузить, перегруженность, перегруженный,  отягощённый.
overflow: переливание через край,  разлив,  наводнение,  избыток, водоотвод, переливаться,  залить,  кипеть,  переливать через край, разливаться,  разлиться, взыграть, переполненный,  паводковой.
overshoot: неудача,  перебор,  переполнение,  перепроизводство, опережение, проскок, Выполняйте посадку с перелётом (типовое сообщение по связи,  м), промахнуться,  пролететь мимо цели,  стрелять лучше,  превосходить, переотклонение.
owe: быть должным,  быть в долгу,  иметь моральный долг,  задолжать, заживать.
pace: с разрешения,  шаг,  длина шага,  пейс, технология контроля приоритетов доступа к носителю, идти шагом,  мерить шагами,  расхаживать,  измерять шагами, хода,  ходовой,  несмотря на мнение,  при всём уважении к, походь, фермент, расщепляющий белок в месте спаренных основных аминокислот, при всём уважении (к кому-либо,  при выражении несогласия: Nor, pace Mr. Smith, was I for one moment defending immorality in the journalist. – Я также, при всём уважении к мистеру Смиту, ни в коей мере не защищал аморальность журналиста. alexs2011),  с разрешения.
palmer: паломник,  искусственная приманка для ужения рыбы,  шулер,  фокусник, Палмер,  Пальмер.
parallelepiped: параллелепипед, брус.
partition: деление,  межкомнатная перегородка,  перегородка,  загородка, распределение (в некоторых контекстах,  например: распределения гормонов фертильности olga don), раздел Электронная изоляция устройства Ethernet от сети. Продукция Bay Networks поддерживает автоматическую изоляцию сбойных портов. 2) Зарезервированный или изолированный сегмент памяти или диска в компьютере или сетевом устройстве), делить,  разделять,  ставить перегородку,  отделять перегородкой, перегородки.
passable: подходящий человек,  имеющая брод,  имеющий обращение, проезжий,  судоходный,  хороший,  достаточный, езжалый.
passage: коридор,  прохождение,  проход,  ход, проран, двигаться боком,  принимать вправо или влево,  двигаться боком,  совершать переезд, проран,  сенки,  сенцы,  ходовой.
pave: мощёная улица, способ закрепки мелких камней в ювелирное изделие, при котором они все выравниваются в одну линию,  как вымащивание мостовой,  драгоценные камни, подобранные заподлицо,  настелить, выстилать,  выложить камнем,  вымащиваться,  выстилаться, устелить, перемащивать,  перемостить, досмаливать,  досмолить, перфторалкилвинилэфир.
peculiarity: специфичность,  характерная черта,  отличительное качество,  свойство, особенности,  особенности.
penalize: подвергать взысканию, наказывать,  делать наказуемым,  наказать,  оштрафовать, наказывать.
permanent: бесконтактный сельсин,  перманентность, неизменный,  долговременный,  перманентный,  остаточный.
permissible: предохранительное взрывчатое вещество, позволительный,  безопасный,  допустимый, позволительно,  допустимо,  можно.
permit: разрешение,  дозволение,  санкция,  разрешительный документ, позволяет, позволять,  разрешать,  давать разрешение,  разрешить, пропускной.
perturb: смущать,  тревожить,  беспокоить,  волновать.
perturbation: волнение,  смятение,  пертурбация,  расстройство, неравенства,  возмущения,  пертурбации, отклонение.
perturbed: смущать,  тревожить,  беспокоить,  волновать, взвинченный.
photometry: фотометрия.
pleiad: Плеяда, плеяда.
ply: фанера,  складка,  оборот,  уклон, глубина просмотра позиции в полуходах, скручивать,  заниматься,  усиленно угощать,  усердно работать, усердно работать чем-либо, -слойный.
polytechnic: политехнический институт или колледж,  политехникум,  политехнический институт,  политехнический колледж, политехника, политехнический, многопрофильный.
postfix: ставить в конец,  слог, приставленный к концу слова,  буква, приставленная к концу слова,  приставлять слог к концу слова, постфиксный.
posture: стойка, положение,  позиция,  поза,  осанка, вызывающе вести себя,  давать положение,  ставить в позитуру,  располагать.
pound: фунт стерлингов,  ливр,  поколотить,  растолочь, гривенка, фунт, огороженное место для загона скотины, паунд,  паундский ярус,  паундская толща,  паундский век, английские фунты, молотить,  измельчить,  натолочь,  постучать, приют для бездомных животных, перетолочь, поколотить, потолочь, натолочь, околачивание обуви.
precedent: прецедент,  аналог,  описание опыта,  прежний пример, судебная практика – АД),  судебная практика Alexander Demidov), предшествующий,  прежний.
preceding: идти,  стоять,  предшествовать,  превосходить, в предшествии, предыдущий,  предшествующий,  прошлый,  имевший место до, предыдущее положение.
predictive: предвещающий,  предсказательный,  предвосхищающий,  предсказывающий.
prentice: отдавать в обучение,  отдавать кого-либо в подмастерье,  ученик в ремесле,  ученье.
prescribe: назначаться,  прописаться,  прописываться,  назначать.
prescribed: назначаться,  прописаться,  прописываться,  назначать, предписанный,  предусмотренный,  задаваемый,  назначенный.
presence: наличие,  явка,  соседство,  непосредственная близость, король,  королева, уделизм, присутствование.
preserve: консервы,  варенье, охранять от браконьеров,  то, что заготовлено впрок,  зверинец,  заказное место для охоты, усторожить, высшего качества, сохранять,  блюсти,  сберегать,  беречь, консервировать,  сохранять, устеречь.
prevail: восторжествовать,  быть распространённым,  торжествовать,  одержать победу, подговаривать,  подговорить, царить, довлеть,  довлеть над, имеет большую юридическую силу.
prevails: имеет большую юридическую силу, восторжествовать,  быть распространённым,  торжествовать,  одержать победу, подговаривать,  подговорить, царить, довлеть,  довлеть над.
primer: первый слой,  грунтовка, фирма-производитель акустических систем, вводить затравку, первичный,  начальный.
propagation: размножение,  проповедь,  насаждение,  продолжение рода, проповедный.
propellant: топливо для реактивных двигателей,  движущая сила,  компонент топлива, топливо для ракетных двигателей, движущий.
proposal: проект,  план,  заявка,  предложение, объявление,  программа,  план, технико-коммерческое предложение, предположенный.
propulsion: движение вперёд,  сообщение движения,  толчок,  энергетическая установка.
prospect: изыскание,  шанс,  предполагаемый покупатель,  панорама, Проспективное исследование естественной истории коронарного атеросклероза, разведывать,  провести изыскания,  быть перспективной,  делать изыскания, изыскивать, предполагаемый подписчик и т. п..
proximity: близость,  соседство,  вероятность,  доступность, но не ограничивается им... Proximity может быть и сугубо виртуальным понятием, и несёт в себе сочетание характеристик, – удобство, доступность, релевантность и т.п. GoodProximity может стать заключительным аккордом в планировании проекта и принятии решения. goldhelen), неконтактный.
pump: лёгкая бальная туфля,  помпа,  мужская бальная туфля,  туфля-лодочка, насосать, накачать,  качать,  выкачивать,  нагнетать, с накачкой, насасывать, прокачивать, покачать, насосный, ТРК, свойство проективного универсального отображения.
quartic: биквадратное уравнение.
racket: теннисная ракетка,  ракетка,  деревянный болотный башмак,  мошенничество, ракетка, грохотать,  греметь,  мешать шумом,  нарушать.
raft: плот,  паром,  сплав древесины,  гонка леса, микрорафт, переплавлять,  переплавлять на пароме,  переплавлять на плоту,  переплавляться на пароме, переплавить,  переплавлять, гнать, доплавить, полимеризация путём обратимого присоединения и фрагментирования.
ram: баран,  гидравлический таран,  коксовыталкиватель,  подъёмник, микрорентген в час, Овен, Международное исследование надёжности заводов и эффективности ремонтов, быстрое закачивание ионов кальция в матрикс, налететь на (at, against, into,  что-либо),  втискивать,  вдалбливать, бойка, затрамбовать,  затрамбовывать, втолковать,  втолковывать, дослать, бараний, на основе социального соответствия.
rapid: пороги,  стремительный поток,  быстрина, стремнина, быстрый,  скорый,  быстроходный,  крутой, самый быстрый, более быстрый, РАПИД (imaging energetic particle spectrometer,  спектрометр высокоэнергетических частиц с формированием изображения), быстро.
reachable: досягаем.
recall: сигнал к возвращению,  воспоминание в памяти,  отозвание,  отзыв, припоминать,  вспоминаться,  вспомниться,  отзываться, шлюпкам возвратиться!, отозвать.
recherche: с изыском,  на любителя.
recon: рекогносцировка,  согласование,  разведка, подсчитывать.
recur: снова возникать,  возвращаться (to,  в речи, мысленно к чему-либо),  возвращаться, восстановиться.
recursion: рекурсия, возвратный,  рекурсивный.
redetermine: уточнять.
redundancy: чрезмерность,  избыток,  излишек рабочей силы,  сокращение рабочих, резервирование, дублирующие.
referential: относящийся к справке,  предназначенный для справки, относящийся (to,  к чему-либо).
refine: очищать,  совершенствовать,  удалить,  делаться более изящным.
regulatory: законодательное регулирование, ОНиЗА, регламентирующий,  регулирующий,  регуляционный,  нормативный правовой.
reinforcement: усиление,  укрепление,  подкрепление,  подспорье, маршевые части, пополнение, арматурный,  усиливающий.
relative: ближний, родственник,  родственница,  соотносительный, сродство, относительный,  условный,  сравнительный,  соответственный.
relay: смена,  почтовая станция,  переключатель,  эстафета, реле, промежуточное Реле, сменять,  обеспечивать смену,  сменить,  обеспечить смену, эстафетный.
remark: замечание,  заметка,  внимание,  примечание, Ремарк, высказываться,  заметить,  наблюдать,  отмечать, замеченный, тот, кто примечает.
rendezvous: место свидания,  место встреч,  сбор войск в назначенном месте,  сбор кораблей в назначенном месте, стыковка, встречаться,  прибывать на место встречи,  встретиться,  встречаться в назначенном мести, стыковаться,  состыковаться, состыковаться,  стыковаться,  стыковка.
repel: отразить,  отражать,  отгонять,  отталкивать, отталкиваться,  оттолкнуться, отбойный, отражённый, отгрызнуться (semelfactive of отгрызаться,  грозить укусом, издавать угрожающие звуки, защищаясь от нападения или угрозы,  огрызаться).
repository: вместилище,  хранилище,  склад,  наперсник, могильники, репозитарий R / 3, дюрантный,  депонированный.
repulsive: отталкивающий,  омерзительный,  отвергающий,  отвратный.
rescue: спасать,  избавлять,  освобождать,  спасти, спасательный.
resent: негодовать,  возмущаться,  обижаться,  возмутиться, снова послать,  повторно направить,  отсылать назад, негодовать по по-воду,  не терпеть, тот, кто питает злобу,  тот, кто помнит зло,  злопамятный,  мститель.
residual: остаток,  остаточный продукт,  остаточные явления,  разность, отходы производства,  мусор, оставшийся необъяснённым,  остаточный,  частично завершённый,  шлаковый.
response: отклик,  ответ,  реакция,  реагирование, ремиссия, отвечать, оперативный,  ответный.
retain: сохранять,  удерживать,  хранить в памяти,  приглашать.
reveal: отображение,  показ, четверть,  откровение,  открыть,  обнаружение, обличить,  открывать,  раскрывать,  вскрывать, раскрываемый, открывать, выявить.
revise: проверка,  сверка,  сводка,  вторая корректура, проверять,  ревизовать,  менять,  проверять и исправлять, проверять,  просматривать, освежить в памяти,  повторить.
revised: проверять,  просматривать, проверять,  ревизовать,  менять,  проверять и исправлять, освежить в памяти,  повторить, проверенный,  исправленный,  пересмотренный,  последняя редакция.
revolve: поворот круга,  вращающаяся сцена, вращать,  вызывать вращение,  вертеться,  идти по кругу, пробуксовать,  пробуксовывать, вращаться.
ridge: гребень,  хребет,  горный кряж,  горный хребет, гребень,  кряж, грива, хребетный столб,  вершина,  кряж,  кровля дома, образовывать складки,  морщить,  топорщиться,  делать конёк на крыше, высота.
rightmost: самый крайний или правый,  крайний справа,  самый крайний,  самый правый.
rigorous: тщательный,  неумолимый,  безжалостный,  точный.
rigorously: строго,  сурово,  неукоснительно,  методично.
ripple: рябь,  волнистость,  волнистая выработка,  журчание, чесалка, покрывать рябью,  струиться,  ниспадать мягкими складками,  прокатываться, мык,  мыканье, вытеребливать, рябеть, мыкать, взволноваться, сморщить, неравномерный.
rive: дырка,  прорез,  разрез, раскалывать,  расщеплять,  разрубать,  разрываться, выкалывание,  раскалывание,  расщепление.
roof: крыша,  кровля,  кров,  империал, крыши, крыть,  настилать крышу,  покрывать,  образовывать крышу, крепёж, потолочный.
rove: шайба,  странствие,  ровница,  прогулка, бассорские дубильные орешки, скитаться,  блуждать,  пропускать через блок,  странствовать, взятый (о снасти,  за),  обнесённый.
rover: скиталец,  разбойник,  ровер,  пират, разбойник, красноглазковые,  эммелихтовые, "бродяги" и "Донкастер Роверс" Юрий Гомон), собачка,  ветреник,  ветрогон,  непостоянный человек, дистанционный улучшенный приёмник видео в оптическом диапазоне частот.
royal: большой формат бумаги,  формат писчей бумаги,  находящийся под покровительством английского короля,  формат печатной бумаги, королевский,  колоссальный,  королевский,  британский, пингвин Королевский.
ruin: гибель,  крушение,  разорение,  крах, разруха, изволочить, похерить,  губить,  извести,  разорять, пролежать,  пролёживать, перепортить, стравить,  стравливать, перековеркать,  перековеркивать, обхлёстывать, расхлёстывать.
saddle: седловина,  салазки,  суппорт,  союзка, полозья, панно, взваливать,  обменять,  обременять,  садиться в седло, возлагать,  возлагать на плечи,  взваливать на плечи,  взвалить на шею, переседлать,  пересёдлывать, напрячь, взваливать, нагнуть, панно,  седелка,  шорный.
sake: саке, вот это да!, ну и ну!.
sate: продажа,  сбыт, насыщать,  насытить,  пресыщать,  пресытить.
schilling: шиллинг.
secular: принадлежащий к белому духовенству,  мирянин,  происходящий раз в сто лет,  возражающий против церковного образования, светский,  мирской,  нецерковный,  вековой.
separation: отделение,  разъединение,  разделение,  разобщение, цветоделённые плёнки,  комплект цветоделённых фотоформ, отделение, отделяться, расщепление.
separatrix: линия, разделяющая свет и тень,  разделительный значок,  косая черта,  запятая или пробел.
settle: деревянная скамья с высокой спинкой,  скамья-ларь,  скамья,  загадат,  settle for,  settle with, подселить,  подселиться,  подселять,  подселяться, населиться,  населяться, расселить,  расселиться,  расселяться, прививаться,  привиться, основываться, устояться, наседать, основаться, устаиваться, насесть, останавливаться, укрепить, усадить, просаживаться, налетать, улежаться, прилечь, оседать.
settlement: оседание,  заселение,  колонизация,  поселение, посад, акт распоряжения имуществом, разделка, поселковый.
severe: перерезать,  сильный, перерезаться,  разрезать,  разрывать,  разрываться, суровый,  жёсткий,  тщательный,  простой, сердитый.
severely: лихо,  резко,  строго,  сурово.
shaft: шахта,  ствол,  колодец,  стрела, валы, сноп, прилаживать,  управлять при помощи длинного шеста,  обижать,  притеснять, снабжённый древком,  снабжённый дышлом,  снабжённый оглоблями,  снабжённый столбом, ноги, оглобельный,  ремизный, Общество за отмену преподавания ФОРТРАНА.
shore: берег,  побережье,  страна,  подпорка, Шор, прибой, набережье, подпирать,  укреплять,  подпереть,  сходить на берег, выстригать,  выщипывать, укрепление стенок.
sick: болезнь,  связанный с болезнью,  больные,  вызванный психозом, натравливать,  натравить,  недомогать,  заставить кого-л делать, охрененно,  нездоровый,  уставший,  болезненный, ужасно классно!,  ужасно!.
sidewinder: удар сбоку, управляемый реактивный снаряд "Сайдуиндер" класса "воздух-воздух".
sight: зона видимости, зрение,  взгляд,  первый взгляд,  точка зрения, Программа "Стратегические действия по переходу на использование водорода, полученного с применением экологически чистых технологий" a year with an associated energy capacity addition of about 125 GW by 2030, the Indian government said.
The incentive plan is worth some 197.4 billion rupees though the government expects investments totaling 8 trillion rupees in the green hydrogen sector by 2030.
The incentive program aims to make green hydrogen affordable and bring down its production cost from current levels of 300-400 rupees a kilo, industry sources told Reuters.
Some 174.9 billion rupees is earmarked for the ‘Strategic Interventions for Green Hydrogen Transition' program, 14.7 billion rupees for pilot projects, and 4 billion rupees for research and development, the government said.
 amorgen), прицел, увидеть,  обнаружить,  наблюдать,  высмотреть, до востребования.
sighting: прицеливание,  случай наблюдения,  достопримечательность, наблюдение, увидеть,  обнаружить,  наблюдать,  высмотреть, визирный.
significantly: значительно,  выразительно,  важно отметить,  следует отметить.
singularity: оригинальность,  своеобразие,  неповторимость,  специфичность.
sire: ваше величество,  сир,  отец,  предок, предки, быть производителем,  давать потомство,  порождать,  родить, произведённый на свет, Международная система критериев и отчётности проверки судов.
sketch: эскиз,  набросок,  зарисовка,  очерк, кроки, писать этюд,  рисовать эскизы,  делать наброски,  нарисовать эскиз, выполнить эскиз,  набросать эскиз, коротко изложенный, эскизный.
skew: уклон,  наклон,  скос,  вывих, анти-, отклонить,  отклонение, «перекос» временной диаграммы, уклоняться,  сворачивать в сторону,  перекашивать,  смотреть искоса, косой,  асимметричный,  наискось,  раскосый.
slew: обхитрить,  быстро поворачивать,  вращаться, развернуться,  развёртываться,  разворачиваться.
smith: рабочий по металлу,  кузнец,  ковач, как компонент сложных слов, придающий значение: рабочий или мастер,имеющий дело с различными металлами, Уильям Смит, выковывать.
solely: разве что,  исключительно,  и только,  единственно.
sought: пытаться найти,  просить,  обращаться,  разузнавать, искомый,  запрашиваемый,  испрашиваемый.
sour: кислятина,  кислый раствор,  недовольный, уквасить, удельная скорость поглощения кислорода (на один микроорганизм,  specific oxygen uptake rate Holly Golightly), скисать,  прокисать,  заквашивать,  мрачнеть, уквашивать, раскисать,  раскиснуть, острый,  едкий,  в дурном расположении духа,  неприятно.
span: спен,  интервал,  промежуток времени,  период времени, % диапазона, длина пролёта, перекрывать,  охватывать,  измерять,  строить мост, перекинуть, статистическая обработка и анализ.
sparse: неплотный,  разбросанный,  рассеянный,  жидкий, реже.
spatial: пространственный,  существующий в пространстве,  занимающий какое-либо пространство,  географический.
speculum: векорасширитель,  блефаростат, рефлектор,  отражатель,  зеркало,  расширитель, влагалищное зеркало, блестящий.
spiller: тот, кто проливает,  тот, кто просыпает,  особого рода удочка.
springer: миномётчик,  прыгун,  охотник, вспугивающий дичь,  летучая рыба, Шпрингер.
stab: удар,  внезапная острая боль,  штат,  попытка, п Nadezhda_S), колоть,  наносить удар,  вонзать,  ранить, наколотый, закалывать,  заколоть, палочкоядерный.
stall: стойло,  доильный станок,  хлев,  конюшня, станок, денник, стул, застревать,  находиться в стойле,  делать стойло в конюшне,  сделать стойло в конюшне, приостанавливать, захлебнуться, захлёбываться, заглохнуть, захлебнуться,  аэрд. срыв,  станковый,  оглавль.
stark: Штарк, штарковский,  stark raving mad, Старк.
steer: молодой бык,  вол,  телец, управлять рулём,  следовать,  направлять,  руководить, прируливать,  прирулить, урегулированный, бычина.
steering: координация,  ведение,  управление,  штурвальный, управлять рулём,  следовать,  направлять,  руководить, прируливать,  прирулить, урегулированный, бычина, рулевой.
stem: ножка,  стержень,  род,  племя, растровый просвечивающий электронный микроскоп, вынос, образование на стыке нескольких наук, чубук, происходить,  останавливать,  оказать сопротивление,  преграждать, родовой.
stickler: ярый сторонник,  защитник,  приверженец,  поборник.
stiffness: густота,  сгущённость,  жёсткость,  натянутость, окостенение.
stochastic: вероятный.
straightforward: прямая, прямолинейный,  ясный,  честный,  откровенный, прямо.
strain: штамм,  натяжение,  растяжение,  напряжение, мкм/м, остаточная деформация, штамм, деформировать,  натягивать,  растягивать,  растягиваться, оттягивать,  оттянуть, напряжение, поднатуживать,  поднатужить, деформационный,  несущий,  силовой,  штаммовый.
stretch: вытягивание,  простирание,  усилие,  плёс, подтяжки, растягивать,  удлинять,  растягиваться,  вытягиваться, вытягивать,  раскидывать,  растягиваться,  вытянуть, вытягиваться,  натягиваться,  вытянуться,  натянуться, расколачивать,  расколотить, подостлать,  подстелить, раздать, дотянуться,  дотягиваться, распяливать,  распялить, слайдеры, тянуться, порасправить, пялить, растягивающийся, безразмерный.
strip: узкая полоска,  длинный, узкий кусок,  полоска,  аэрофотосъёмочный маршрут, полосковый светильник, смонтированный горизонтально сверху или снизу круговой панорамы для мягкого или равномерного освещения, стрип,  отделение купона от основной облигации,  стрипованная облигация, загон, полоса, штрипс, штрипс, планка, участок, лента стрипс, жёсткая лента, резать на длинные, узкие куски, дранье, раздеть, сдирать что-либо с, надирать, передирать, лупить, свертеть, на полоски.
stripe: полоса,  полосатый материал,  удар бичом,  кайма, подтёк, нашивка, испещрять полосами,  делать бороздки,  испещрить полосами,  делить землю на делянки, лычки, полосчатый.
subplot: субделянка, субделянка.
subsequent: являющийся результатом чего-либо, последующий,  более поздний,  являющийся результатом,  подобострастный, вслед за.
subspace: часть рабочего пространства, подпространственный.
substantial: по сути,  по существу, существенные части, прочный,  крепкий,  солидный,  питательный.
substantially: значительно,  по сути,  практически,  по сути дела.
summand: слагаемое суммы.
sumption: предположение,  допущение.
supplemental: дополнение,  дополнительные устройства,  дополнительное оборудование, резервные энергоносители,  энергоносители сжиженный природный газ и искусственные газы, дополняющие природный газ, дополнительный,  добавочный,  прибавочный.
suppress: запрещать,  подавлять,  закрывать,  скрывать, унимать,  унять, остановить.
suppression: подавление,  запрещение,  закрытие,  скрытие, скрывать.
surpass: перекозырять, превосходить,  перегонять,  обгонять,  превышать, переплёвывать,  переплюнуть, переиграть,  переигрывать, превзойти (в чём-либо,  кого-либо).
surrey: Суррей,  граф. Суррей, лёгкий двухместный экипаж.
swarm: рой,  масса,  туча,  стая, масса,  множество, комплекс,  группировка, толпиться,  кишеть,  роиться,  взбираться, роить, роёвщина, дистанционно управляемый боевой модуль компании Thales.
synthesize: синтезирование, синтезироваться,  обобщить.
synthetic: сочетающий разные элементы,  характеристики, синтетический продукт,  искусственный драгоценный камень,  искусственный,  комплексный.
systematic: систематический,  методичный,  методический,  систематически изложенный, систематический.
tailor: портной,  торговец мужским платьем, портные, шить,  шиться,  портняжничать,  выдерживать в стиле мужской одежды, портновский.
tangent: прямой участок железнодорожного пути,  тангентальный,  нравоучение, сорваться,  срываться,  странно себя повести,  странно себя вести, касательный.
tank: систерна,  искусственный или естественный водоём,  колебательный контур,  бачок, ёмкость, баковое оборудование, вместилище, бачок, ёмкость, Танк, танки!, наливать в бак,  сохранять в баке,  обрабатывать в баке,  обработать в баке, резервуары,  тенки,  ёмкости, танковый.
tedious: скучный,  нудный,  томительный,  банальный.
teed: класть мяч для первого удара,  положить мяч для первого удара.
terrestrial: землянин,  земнородный,  обитатель земли, земной,  светский,  наземный,  юдольный.
testbed: экспериментальная система, экспериментальный ЛА.
tether: путы,  оковы,  узы,  граница, привязать,  привязывать,  ограничивать,  сковывать.
thence: из этого,  от этого времени, отсюда,  с того времени,  с этих пор,  вследствие этого.
thereby: из-за этого,  в связи с этим,  с помощью этого, таким образом,  посредством этого,  тем самым,  вследствие этого.
though: разве,  правда,  пусть,  однако • According to McCants, this will change the energy of your home without having to change your physical address. Be careful what you change it to, though. -- Однако будьте осторожны ... ART Vancouver), хотя,  несмотря на,  хоть и,  словно.
threat: негативный фактор,  повышенная опасность,  бедствие, гроза, грозить,  стращать, атакующий ЛА, СНП.
threshold: преддверие,  канун,  дверной порог,  грань, параметры,  пороги, Изогелия, лимитный.
tidal: подверженный действию приливов,  связанный с приливом и отливом,  приходящий во время прилива,  относящийся к приливу и отливу, приливной,  приливо-отливный.
tidally: tie: галстук,  бечёвка,  лента,  шнур, присупонить, самовяз, завязывать бантом,  завязывать узлом,  перевязать,  равнять счёт, привязать,  привязывать,  скрепить, обвязывать,  обвязать, приматывать,  примотать, прихлёстываться, навязать, присупонивать, завязать, связанный, Европейская ассоциация производителей игрушек.
tilt: наклоняться,  наклонять,  накрениваться,  накрениться, набекренить, наклонный.
tod: хитрец,  ловкач,  пройдоха,  единица веса шерсти, точка начала снижения.
tolerant: терпимый,  относящийся терпимо,  толерантный,  толерантный человек, либеральный.
torque: наддув,  динамометрический ключ, вращающий момент,  крутящий момент, крутящий момент, закрутить,  закручивать, искривленный.
tow: буксир,  буксировка,  трос,  буксируемое судно, очесы,  пакля, куделя,  кужель, прядево, сцеп, тянуть на бечеве,  тянуть баржу на бечеве,  протягивать,  протягиваться, пробуксировать, буксируемый ЛА, ПТРК TOW (BGM-71 Missile Weapon System, transaction: сделка,  ведение,  дело,  труды, записки,  труды,  протоколы,  труд, записки,  труды.
transceivers: трансиверы, приёмно-передатчик, трансивер.
transference: перевод,  передача,  переброска,  передача.
transient: беспризорник, нечто временное,  нечто неустойчивое,  безработный бродяга,  подскок, недокументальная копия,  экранная копия,  мягкая копия, импульсные шумы, преходящий,  кратковременный,  мимолётный,  временный.
transition: период адаптации,  адаптация,  перерождение,  переход, альфа-переход, гамма-переход, В-переход, преобразования, фазовый переход, переводиться,  быть в процессе смены пола,  переводить,  переключаться, воспроизвести, переходный.
treatment: обращение,  обхождение,  трактовка,  лечение, лечение, средства для лечения, переработка, долечиваться,  долечиться, лечебный.
trial: судебное разбирательство,  испытание,  тяжёлое испытание,  разведка, испытания,  мучения,  страдания,  опыты, тройственное число, судилище, обкатать,  испытывать,  рассматривать дело по существу, пробный,  испытательный,  пристрелочный,  пристрельный.
tug: рывок,  дёрганье,  тянущее или дёргающее усилие,  усилие, гуж, дёргать,  трудиться,  тяжело работать,  бороться, потянуть,  рвать, подёргать,  подёргивать, рванье, буксирный, подёргивать.
tumble: падение,  беспорядок,  смятение,  переворачивание, упасть,  свалиться,  скатиться,  шлёпнуться, сверзиться.
tuning: настройка,  налаживание,  регулировка,  синтонизация, подстройка, тюнинг, юстирный, настроиться,  подстроиться,  устанавливать,  устанавливаться, гармонировать, подстроечный,  установочный,  юстирный,  юстировальный.
uncertainty: неуверенность,  нерешительность,  изменчивость,  неопределённость, неопределённости.
unconstrained: невынужденный,  добровольный,  непринуждённый,  естественный.
uncontrollable: неукротимый,  неудержимый,  не поддающийся контролю,  слепой, навзрыд,  без удержу, неуёмный.
undirected: незапланированный,  ненаправленный,  лишённый руководства,  не имеющий адреса.
unfold: расстилать,  развёртываться,  распускаться,  раскрывать.
uniaxial: имеющий одну ось,  монаксиальный.
uniformly: равным образом,  все как один,  через одинаковые промежутки,  поголовно.
unitary: единичный,  единый.
univocal: однозначный,  недвусмысленный,  ясный,  очевидный.
unrestricted: высвобождать, неограниченный,  вольный,  не запрещённый,  разрешённый.
unsteady: нетвёрдый,  неустойчивый,  непостоянный,  колеблющийся, развинченный.
utilizes: утилизировать, использовать,  заполняться,  расходовать,  использоваться.
validation: придание законной силы,  легализация,  подтверждение,  признание беспристрастным или объективным.
vantage: выгода,  преимущество somebody at a vantage – иметь преимущество перёд кем-либо),  удобство,  авантаж.
vernal: свежий,  весенний,  молодой.
vice: порок,  зло,  недостаток,  дефект, вице -, полиция нравов, сжимать,  стискивать,  зажимать в тиски, вместо, виц-,  вице-.
vicinity: соседство,  близость,  окрестности,  район, окружение, окрестности, поблизости,  прилежащий.
viewpoint: позиция,  ТЗ,  представление,  смотровая площадка, точки зрения, точка зрения,  точка,  аспект,  угол зрения, ТС.
viscous: липкий,  клейкий,  вязкий,  густой.
vortex: вихрь,  омут,  водоворот,  пучина, перемешивать на вортексе, вихревой.
walker: валяльщик,  скороход,  карта-путеводитель,  обувь для ходьбы, быть не может!, клавишный соломотряс, гуляющий,  мимо!.
wan: подёрнутый пеленой, мировая сеть, Ван, покрывать бледностью,  делать тусклым, серым,  стать серым,  изнурять, измождённый,  белёсый,  чахлый,  дохлый, глобальная сеть, WAN.
wand: тонкая палочка,  прут,  жезл,  скипетр, гимнастическая палка, ветви, проверять ручным металлодетектором, жезл, распространение ПО по глобальной сети.
ward: выступ,  попечительство,  административный район города,  район, Уорд, палатский, отражать,  парировать,  отвращать,  защищать, подопечный,  опекаемый.
westward: запад,  направленный на запад,  обращённый к западу,  движущийся на запад, западный,  на запад,  на западе.
whereas: потому что,  так как, принимая во внимание,  поскольку,  между тем как,  если.
wherein: где,  там,  в чём,  когда The vehicle may also be driven in an "assist" mode wherein the engine is operated and used as the primary source of torque for powering wheels and the electric motor is used as an additional torque source to act in cooperation with. I. Havkin).
whilst: время,  минута,  мгновение, мешкать,  медлить,  копаться, в то время как,  при этом,  к тому же,  пока.
wise: что касается, СПТИ (социальные предприятия трудовой интеграции,  work integration social enterprises OKokhonova), надоумить,  подбросить идею, дерзкий,  нахальный,  здравомыслящий,  здравый, в отношении,  в том, что касается, исходя из,  по поводу,  по части,  в зависимости от.
wobble: угловое колебательное движение управляемых колёс, шатание,  дрожание,  виляние,  вихляние передних колёс, биение, качаться,  шататься,  вихлять,  проявлять нерешительность.
worthwhile:  дающий результат,  выгодный,  пользительный, нелишне.
wright: мастер-ремесленник,  ремесленник,  работник, Райт.
wrist: запястье,  обшлаг,  крага,  цапфа, цапфа, наручный.
yang: тополь Симона,  тополь китайский,  двукрылоплодник, янь.
yaw: отклонение от направления,  отклониться,  отклоняться,  хроническая накожная болезнь, вильнуть, находящийся под ненулевым углом атаки,  находящийся под ненулевым углом рыскания,  находящийся под ненулевым углом скольжения,  не совпадающий с направлением потока.
york: Йорк, страдать рвотой.
